██E██████████████
██PPPPPPPPPP█████
███████████P█████
██████PPPPPP█████
██████P██████████
██████PPPPPPPPPPF
█████████████████